"a" = (/turf/closed/wall/mineral/titanium,/area/template_noop)
"b" = (/obj/effect/spawner/structure/window/shuttle,/turf/open/floor/plating,/area/template_noop)
"c" = (/obj/structure/chair/comfy/shuttle{dir = 1},/obj/machinery/status_display/evac{pixel_x = 32},/obj/machinery/computer/shuttle/pod{pixel_x = -32},/turf/open/floor/mineral/titanium/blue,/area/template_noop)
"d" = (/obj/structure/chair/comfy/shuttle{dir = 1},/obj/item/radio/intercom{pixel_x = 25},/obj/item/storage/pod{pixel_x = -26; unlocked = 1},/obj/machinery/light/small{dir = 8},/turf/open/floor/mineral/titanium/blue,/area/template_noop)
"e" = (/obj/structure/shuttle/engine/propulsion/burst,/turf/closed/wall/mineral/titanium,/area/template_noop)
"f" = (/obj/machinery/door/airlock/titanium{name = "Escape Pod Airlock"},/obj/docking_port/mobile/pod{port_direction = 2; dwidth = 1; width = 3; height = 4},/turf/open/floor/mineral/titanium/blue,/area/template_noop)

(1,1,1) = {"
aba
aca
ada
efe
"}
